{
  "level": 1,
  "row": 4,
  "column": 7,
  "cells": [
    [
      [0,0,0,0,0,0,0],
      [0,0,0,0,0,0,2],
      [1,1,1,0,1,1,1],
      [0,0,0,0,0,0,0]
    ],
    [
      [0,0,0,0,0,0,0],
      [0,0,0,0,0,0,0],
      [1,1,1,0,1,1,1],
      [0,0,0,0,0,0,0]
    ],
    [
      [0,0,0,0,0,0,0],
      [0,0,0,0,0,0,0],
      [1,1,1,0,1,1,1],
      [0,0,0,0,0,0,0]
    ],
    [
      [0,0,0,0,0,0,0],
      [0,0,0,0,0,0,0],
      [1,1,1,0,1,1,1],
      [0,0,0,0,0,0,0]
    ],
    [
      [0,0,0,0,0,0,0],
      [0,0,0,0,0,0,0],
      [0,0,0,0,0,0,0],
      [1,1,1,0,1,1,1]
    ],
    [
      [0,0,0,0,0,0,0],
      [0,0,0,0,0,0,0],
      [0,0,0,0,0,0,0],
      [1,1,1,0,1,1,1]
    ],
    [
      [0,0,0,0,0,0,0],
      [0,0,0,0,0,0,0],
      [0,0,0,0,0,3,0],
      [1,1,1,0,1,1,0]
    ]
  ]
}
