[
  {
    "level": 1,
    "row": 4,
    "column": 7,
    "cells": [
      [
        [0,0,0,0,0,0,0],
        [0,0,0,0,0,0,2],
        [1,1,1,0,1,1,1],
        [0,0,0,0,0,0,0]
      ],
      [
        [0,0,0,0,0,0,0],
        [0,0,0,0,0,0,0],
        [1,1,1,0,1,1,1],
        [0,0,0,0,0,0,0]
      ],
      [
        [0,0,0,0,0,0,0],
        [0,0,0,0,0,0,0],
        [1,1,1,0,1,1,1],
        [0,0,0,0,0,0,0]
      ],
      [
        [0,0,0,0,0,0,0],
        [0,0,0,0,0,0,0],
        [1,1,1,0,1,1,1],
        [0,0,0,0,0,0,0]
      ],
      [
        [0,0,0,0,0,0,0],
        [0,0,0,0,0,0,0],
        [0,0,0,0,0,0,0],
        [1,1,1,0,1,1,1]
      ],
      [
        [0,0,0,0,0,0,0],
        [0,0,0,0,0,0,0],
        [0,0,0,0,0,0,0],
        [1,1,1,0,1,1,1]
      ],
      [
        [0,0,0,0,0,0,0],
        [0,0,0,0,0,0,0],
        [0,0,0,0,0,3,0],
        [1,1,1,0,1,1,0]
      ]
    ]
  },
  {
    "level": 2,
    "row": 4,
    "column": 8,
    "cells": [
      [
        [0,0,0,0,0,0,0,0],
        [0,0,0,0,0,0,0,0],
        [0,0,0,0,0,0,0,2],
        [1,1,1,1,1,1,1,1]
      ],
      [
        [0,0,0,0,0,0,0,0],
        [0,0,0,0,0,0,0,0],
        [0,0,0,0,0,0,0,0],
        [1,1,1,1,1,1,1,1]
      ],
      [
        [0,0,0,0,0,0,0,0],
        [0,0,0,0,0,0,0,0],
        [0,0,0,0,0,0,0,0],
        [1,1,1,1,1,1,1,1]
      ],
      [
        [0,0,0,0,1,1,0,0],
        [0,0,0,0,0,0,0,0],
        [0,0,0,0,0,0,0,0],
        [0,0,0,0,0,0,0,0]
      ],
      [
        [0,0,0,0,0,0,1,0],
        [0,0,0,0,0,0,0,0],
        [0,0,0,0,0,0,0,0],
        [0,0,0,0,0,0,0,0]
      ],
      [
        [0,0,0,0,0,0,0,0],
        [0,0,0,0,0,0,0,0],
        [0,0,0,0,0,0,0,0],
        [1,1,1,1,1,1,1,1]
      ],
      [
        [0,0,0,0,0,0,0,0],
        [0,0,0,0,0,0,0,0],
        [0,0,0,0,0,0,0,0],
        [1,1,1,1,1,1,1,1]
      ],
      [
        [0,0,0,0,0,0,0,0],
        [0,0,0,0,0,0,0,0],
        [0,0,0,0,0,3,0,0],
        [1,1,1,1,1,1,1,0]
      ]
    ]
  },
  {
    "level": 3,
    "row": 6,
    "column": 8,
    "cells": [
      [
        [0,0,0,0,0,0,0,0],
        [0,0,0,0,0,0,0,0],
        [0,0,0,0,0,0,0,0],
        [0,0,0,0,2,0,0,0],
        [0,0,0,0,1,0,0,0],
        [1,1,1,1,1,1,1,1]
      ],
      [
        [0,0,0,0,0,0,0,0],
        [0,0,0,0,0,0,0,0],
        [0,0,0,0,0,0,0,0],
        [0,0,0,0,0,0,0,0],
        [0,0,0,0,0,0,0,0],
        [1,1,1,1,1,1,1,1]
      ],
      [
        [0,0,0,0,0,0,0,0],
        [0,0,0,0,0,0,0,0],
        [0,0,0,0,0,0,0,0],
        [0,0,0,0,0,0,0,0],
        [0,0,0,0,0,0,0,0],
        [1,1,1,1,1,1,1,1]
      ],
      [
        [0,0,0,0,0,0,0,0],
        [0,0,0,0,1,1,1,1],
        [1,1,1,1,1,0,0,0],
        [0,0,0,0,1,0,0,0],
        [0,0,0,0,1,0,0,0],
        [1,1,1,1,1,1,1,1]
      ],
      [
        [0,0,0,0,0,0,0,0],
        [0,0,0,0,0,0,0,0],
        [0,0,0,0,0,0,0,0],
        [0,0,0,0,0,0,0,0],
        [1,1,1,1,1,1,1,1],
        [0,0,0,0,0,0,0,0]
      ],
      [
        [0,0,0,0,0,0,0,0],
        [0,0,0,0,0,0,0,0],
        [0,0,0,0,0,0,0,0],
        [0,0,0,0,0,0,0,0],
        [0,0,0,0,0,0,0,0],
        [0,0,0,0,0,0,0,0]
      ],
      [
        [0,0,0,0,0,0,0,0],
        [0,0,0,0,0,0,0,0],
        [0,0,0,0,0,0,0,0],
        [0,0,0,0,0,0,0,0],
        [0,0,0,0,0,0,0,0],
        [0,0,0,0,0,0,0,3]
      ],
      [
        [0,0,0,0,0,0,0,0],
        [0,0,0,0,0,0,0,0],
        [0,0,0,0,0,0,0,0],
        [0,0,0,0,0,0,0,0],
        [0,0,0,0,0,0,0,0],
        [0,0,0,0,0,0,0,0]
      ]
    ]
  },
  {
    "level": 4,
    "row": 6,
    "column": 8,
    "cells": [
      [
        [0,0,0,0,0,0,0,0],
        [0,0,0,0,0,0,0,0],
        [1,1,1,1,1,1,1,1],
        [0,0,0,0,0,0,0,0],
        [0,0,0,0,0,0,0,0],
        [0,0,0,0,0,0,0,0]
      ],
      [
        [0,0,0,0,0,0,0,0],
        [0,0,0,0,0,0,0,2],
        [1,1,1,1,1,1,1,1],
        [0,0,0,0,0,0,0,0],
        [0,0,0,0,0,0,0,0],
        [0,0,0,0,0,0,0,0]
      ],
      [
        [0,0,0,0,0,0,0,0],
        [0,0,0,0,0,0,0,0],
        [1,1,1,1,1,1,1,1],
        [0,0,0,0,0,0,0,0],
        [0,0,0,0,0,0,0,0],
        [0,0,0,0,0,0,0,0]
      ],
      [
        [0,0,0,0,0,0,0,0],
        [0,0,0,0,0,0,0,0],
        [1,1,1,1,1,1,1,1],
        [0,0,0,0,0,0,0,0],
        [0,0,0,0,0,0,0,0],
        [0,0,0,0,0,0,0,0]
      ],
      [
        [0,0,0,0,1,1,1,1],
        [0,0,0,0,1,0,0,1],
        [1,1,1,1,1,0,1,1],
        [0,0,0,0,0,0,1,0],
        [0,0,0,0,0,0,1,0],
        [1,1,1,1,1,1,1,0]
      ],
      [
        [0,0,0,0,0,0,0,0],
        [0,0,0,0,0,0,0,0],
        [1,1,1,1,0,0,0,0],
        [0,0,0,0,0,0,0,0],
        [0,0,0,0,0,0,0,0],
        [1,1,1,1,1,1,1,0]
      ],
      [
        [0,0,0,0,0,0,0,0],
        [0,0,0,0,0,0,0,0],
        [1,1,1,1,0,0,0,0],
        [0,0,0,0,0,0,0,0],
        [0,3,0,0,0,0,0,0],
        [1,1,1,1,1,1,1,0]
      ],
      [
        [0,0,0,0,0,0,0,0],
        [0,0,0,0,0,0,0,0],
        [1,1,1,1,0,0,0,0],
        [0,0,0,0,0,0,0,0],
        [0,0,0,0,0,0,0,0],
        [1,1,1,1,1,1,1,0]
      ]
    ]
  },
  {
    "level": 5,
    "row": 9,
    "column": 5,
    "cells": [
      [
        [0,0,0,0,0],
        [0,0,0,0,0],
        [0,0,0,0,0],
        [0,0,0,0,0],
        [1,1,1,1,1],
        [0,0,0,0,0],
        [0,0,0,0,0],
        [0,0,0,0,0],
        [1,1,1,1,1]
      ],
      [
        [0,0,0,0,0],
        [0,0,0,0,0],
        [0,0,0,0,0],
        [0,0,0,0,0],
        [1,1,1,1,1],
        [0,0,0,0,0],
        [0,0,0,0,0],
        [0,0,0,2,0],
        [1,1,1,1,1]
      ],
      [
        [0,0,0,0,0],
        [0,0,0,0,0],
        [0,0,0,0,0],
        [0,0,0,0,0],
        [0,0,0,0,0],
        [0,0,0,0,0],
        [0,0,0,0,0],
        [0,0,0,0,0],
        [0,0,0,0,0]
      ],
      [
        [0,0,0,0,0],
        [0,0,0,0,0],
        [1,1,1,1,1],
        [0,0,0,0,0],
        [0,0,0,0,0],
        [0,0,0,0,0],
        [1,1,1,1,1],
        [0,0,0,0,0],
        [0,0,0,0,0]
      ],
      [
        [0,0,0,0,0],
        [0,0,0,0,3],
        [1,1,1,1,1],
        [0,0,0,0,0],
        [0,0,0,0,0],
        [0,0,0,0,0],
        [1,1,1,1,1],
        [0,0,0,0,0],
        [0,0,0,0,0]
      ]
    ]
  }
]